111111111111
100PCE000001
111111111111