1111111111111
1001000000C11
1000011110011
1P00110000111
1111111111111