11111111
1P00E001
1C010101
11111111
